#....................................................#
#....................................................#
#....................................................#
#....................................****************#
#..................................#.................#
#...............................#....................#
#............................#.......................#
#.........................#..........................#
#......................#.............................#
#************.......#................................#
#................#...................................#
#.........####.......................................#
######################################################
