#...........#
#...........#
#.P......U..#
#E..........#
#***....C...#
#...........#
#.....*.....#
#...........#
#...*.......#
#...........#
#.*.........#
#C..........#
#############
