#...........#
#...........#
#.U.........#
#.....C.....#
#***........#
#...........#
#...........#
#...........#
#...........#
#...........#
#.........PC#
#E.E.E.E.E.E#
#############
