#.................................#
#..........C......................#
#.................................#
#......C...#...C..................#
#..................C......U.......#
#......#...C...#..................#
#..................#....*****.....#
#CCCC......#......................#
#****.............................#
#.................P...............#
#.................................#
#...E............E.............E..#
###################################