#................................P#
#.................................#
#.................................#
#.................................#
#.................................#
#...............U.................#
#.................................#
#.................................#
#.................................#
#.................................#
#.................................#
#.................................#
###################################